# # # # # # # # # # # # # # # # #
# T . . . . . . . . . # . # . . #
# # # # # . # # # . . . . # . # #
# . . . . . . . . . # . . . . . #
# . # # # . # . # . # . # . # . #
# . # . # . # . # . # . # . # . #
# . # . # . # # # . . # # . # . #
# . # . . . # . # # . # . # . . #
# . . . # # # . . # . . . . . # #
# . . . . . . . # # . # # . . . #
# # # # . # . . . # # # . . # . #
# . . . . # . # . . . # # . # . #
# . # # . # . # . # . . . . . . #
# # # # # # # # # # # # # # # S #
