# # # # # # # # # #
# T # . . . . . . #
# . # . # # . . . #
# . . . . . # . S #
# # # # # # # # # #
